NO ./assets/texture/brick1.png
SO ./assets/texture/brick2.png
WE ./assets/texture/brick3.png
EA ./assets/texture/brick4.png




C    1,6,238



F 1,69 ,	22



1111111111111111111111111111111111111
1000000000000000000000000000000000001
1000000000000000000000000000000000001
1000000000000000000000000000000000001
1000000000000000000000000000000000001
1000000000000000E00000000000000000001
1000000000000000000000000000000000001
1000000000000000000000000000000000001
1000000000000000000000000000000000001
1111111111111111111111111111111111111



 
  

   
    
	 

	  
	   

	    
		 
		  

