  		SO  	 ./texture/south

		
      F    	255  ,  100 ,           		0



 	 NO   	 ./texture/north
       
 	 	WE ./texture/west
C 5,0,0
 	 	EA ./texture/west

        1111111111111111111111111
        1000000000110000011100001
        101100000111000001E110001
        1001000000000000011100001
111111111011000001110000000000001
100000000011111111110111111111111
111101111111       1000010001
111101111111       1010010001
110000001101       1000010001
10000000000111111111000000001
10000000000000001100010010001
1100000111010101111001111000111
11110111 1110101 100111000001
11111111 1111111 111111111111
 
  

   
    

	 
	  

	   


	    
		 

		  		
					
						

								
									

										
											
												
