  		SO  	 ./texture/south

		
      F    	255  ,  100 ,           		0



 	 NO   	 ./texture/north
       
 	 	WE ./texture/west
C 5,0,0
 	 	EA ./texture/west

        1111111111111111111111111      11111111111
        100000000011000001110000111111110000000001
        101100000111000001E11000000000000000010001
        100100000000000001010000000000000000010001
11111111101100000111000000000000111111110000000001
100000000011111111110111111111111      11111001111
111101111111       1000010001              1001
111101111111       1010010001              1101
110000001101       1000010001              1001
10000000000111111  111000000011            1011
10000000000000001  100010010001            1001
11000001110101011  11001111000111          1101
11000111 1000101   100111000001            1001
11000111 1111111   111111111111            1011
 10001                                     1001
 1000111111111111111111111111111111111111111001
 1000010000000000000001110000000000001000000001
 1000000000100000000001100000010000000000000001
 1000100000000000000000000000000000000001000001
 1111111111111111111111111111111111111111111111
