NO ./texture/brick1.png
SO ./texture/brick2.png




C    127,206,238
WE   ./texture/brick3.png

EA ./texture/brick4.png


F 1, 69 ,	22


1111111111111111111111111111111111111
1000000000000000000000000000000000001
1000000000000000000000000000000000001
1000000000000000000000000000000000001
1000000000000000000000000000000000001
1000000000000000E00000000000000000001
1000000000000000000000000000000000001
1000000000000000000000000000000000001
1000000000000000000000000000000000001
1111111111111111111111111111111111111


 
  

   
    
	 

	  
	   

	    
		 
		  

