NO ./texture/north
SO ./texture/south
WE ./texture/west
EA ./texture/east


F 255  ,  100 ,0
C 5,0,0
    
10101010101010101010
01010101010101010101
10101010101010101010
   01010101010101010101
10101010101010101010
01010101010101010101
10101010101010101010
01010101010101010101
10101010101010101010
01010101010E01010101
    10101010101010101010
01010101010101010101
10101010101010101010
01010101010   101010101
10101010101010101010
01010101010101010101
10101010101010101010
01010101010101010101
10101010101010101010
01010101010101010101
