   	NO  		 ./texture/brick1.png   			
SO ./texture/brick2.png
WE ./texture/brick3.png
EA ./texture/brick4.png

F 	   5  , 100 ,7
C 5,0,0
    
	



11111111111111111111
11010101010101010101
11000000010101010101
11010000010011111111
110000000001N0000001
11010101010111111111
11111111111111111111



    

	 
	  
