NO ./texture/north
SO ./texture/south
WE ./texture/west
EA ./texture/east


F 255  ,  100 ,0
C 5,0,0
    
11111111111111111101
11010101010101010101
11000000010101010101
11010000010001010101
110000000001S0000001
11010101010101010101
11111111111111111111
