NO ./texture/brick1.png
SO ./texture/brick2.png
WE ./texture/brick3.png
EA ./texture/brick4.png


F 255  ,  100 ,0
C 5,0,0
    
11111111111111111111
11010101010101010101
110D0000010101010101
110100000D0D01010101
110D00000101N0000001
11010101010101010101
11111111111111111111
