NO ./texture/north
SO ./texture/south
WE ./texture/west
EA ./texture/east
F 255  ,  100 ,0
C 5,0,0


111111
100101
101001
1100N1
111111
